{
    "map":[
        [1,1,1,1,1,1,1,1,1,1,1,1,1,1,1,1],
        [1,1,1,1,1,1,1,1,1,1,1,1,1,1,1,1],
        [1,1,1,1,1,1,1,1,1,1,1,1,1,1,1,1],
        [1,1,1,1,1,1,1,1,1,1,1,1,1,1,1,1],
        [1,1,1,1,1,1,1,1,1,1,1,1,1,1,1,1],
        [4,5,6,1,4,5,6,1,1,1,1,1,1,1,1,1],
        [1,1,1,1,1,1,1,1,1,1,1,1,1,1,1,1],
        [1,1,1,1,1,1,1,1,1,1,1,1,1,1,1,1],
        [1,1,1,1,1,1,1,1,1,1,1,1,1,1,1,1],
        [3,3,3,3,3,3,3,3,3,3,3,1,1,1,1,3],
        [0,0,0,0,0,0,0,0,0,0,0,2,2,2,2,0]
    ],

    "background" :[
        
    ]
}